10,40
########################################
#W                                     #
#                 #######+++#####      #
#                                      #
###   ####      #######                #
###+++####         ####      ######    #
#                     +           #    #
#          ####### ###### ####    #    #
#                + #####   ###         #
########################################
